{
    "map":
    [
        ["#", "#", "#", "#", "#", "#", "#", "#", "#"],
        ["#", ".", "M",".", ".", ".",  ".", ".", "#"],
        ["#", ".", ".",".", ".", ".",  "Z", ".", "#"],
        ["#", ".", ".",".", ".", ".",  ".", ".", "#"],
        ["#", ".", ".",".", ".", "M",  ".", ".", "#"],
        ["#", "O", ".",".", "#", ".",  ".", ".", "#"],
        ["#", ".", ".",".", "#", ".",  ".", ".", "#"],
        ["#", ".", "#", ".", "#", "#", ".", ".", "#"],
        ["#", ".", ".",".", "#", ".",  "O", ".", "#"],
        ["#", ".", ".",".", "#", ".",  ".", ".", "#"],
        ["#", "#", "#", "#", "#", "#", "#", "#", "#"]
    ],
    "name": "level_1"
}