{
    "map":
    [
        ["#", "#", "#", "#", "#", "#", "#", "#"],
        ["#", ".", "M",".", ".", ".",  ".", "#"],
        ["#", ".", ".",".", ".", ".",  ".", "#"],
        ["#", ".", ".",".", ".", ".",  ".", "#"],
        ["#", ".", ".",".", ".", "M",  ".", "#"],
        ["#", "O", ".",".", "#", ".",  ".", "#"],
        ["#", ".", ".",".", "#", ".",  ".", "#"],
        ["#", ".", "#", ".", "#", "#", "#", "#"],
        ["#", ".", ".",".", "#", ".",  "O", "#"],
        ["#", ".", ".",".", "#", ".",  ".", "#"],
        ["#", "#", "#", "#", "#", "#", "#", "#"]
    ],
    "name": "level_1"
}